+---+---+---+---+
|   |           |
+   +---+   +---+
|       |       |
+---+   +---+   +
|   |           |
+   +---+---+   +
|               |
+---+---+---+---+
