 __ __ __ __ __ __ __ __
|  |     |      __ __   |
|   __ __|  |  |     |  |
|        |__|________|  |
|__ __ __ __ __    __   |
|  |   __ __|     |     |
|  |     |      __|__|  |
|__   |   __ __|  |     |
|__ __|__ __ __ __ __ __|